{
    "Ꭰ": "A",
    "Ꭱ": "E",
    "Ꭲ": "I",
    "Ꭳ": "O",
    "Ꭴ": "U",
    "Ꭵ": "V",
    "Ꭶ": "GA",
    "Ꭷ": "KA",
    "Ꭸ": "GE",
    "Ꭹ": "GI",
    "Ꭺ": "GO",
    "Ꭻ": "GU",
    "Ꭼ": "GV",
    "Ꭽ": "HA",
    "Ꭾ": "HE",
    "Ꭿ": "HI",
    "Ꮀ": "HO",
    "Ꮁ": "HU",
    "Ꮂ": "HV",
    "Ꮃ": "LA",
    "Ꮄ": "LE",
    "Ꮅ": "LI",
    "Ꮆ": "LO",
    "Ꮇ": "LU",
    "Ꮈ": "LV",
    "Ꮉ": "MA",
    "Ꮊ": "ME",
    "Ꮋ": "MI",
    "Ꮌ": "MO",
    "Ꮍ": "MU",
    "Ꮎ": "NA",
    "Ꮏ": "HNA",
    "Ꮐ": "NAH",
    "Ꮑ": "NE",
    "Ꮒ": "NI",
    "Ꮓ": "ZO",
    "Ꮔ": "NU",
    "Ꮕ": "NV",
    "Ꮖ": "QUA",
    "Ꮗ": "QUE",
    "Ꮘ": "QUI",
    "Ꮙ": "QUO",
    "Ꮚ": "QUU",
    "Ꮛ": "QUV",
    "Ꮜ": "SA",
    "Ꮝ": "S",
    "Ꮞ": "SE",
    "Ꮟ": "SI",
    "Ꮠ": "SO",
    "Ꮡ": "SU",
    "Ꮢ": "SV",
    "Ꮣ": "DA",
    "Ꮤ": "TA",
    "Ꮥ": "DE",
    "Ꮦ": "TE",
    "Ꮧ": "DI",
    "Ꮨ": "TI",
    "Ꮩ": "DO",
    "Ꮪ": "DU",
    "Ꮫ": "DV",
    "Ꮬ": "DLA",
    "Ꮭ": "TLA",
    "Ꮮ": "TLE",
    "Ꮯ": "TLI",
    "Ꮰ": "TLO",
    "Ꮱ": "TLU",
    "Ꮲ": "TLV",
    "Ꮳ": "TSA",
    "Ꮴ": "TSE",
    "Ꮵ": "TSI",
    "Ꮶ": "TSO",
    "Ꮷ": "TSU",
    "Ꮸ": "TSV",
    "Ꮹ": "WA",
    "Ꮺ": "WE",
    "Ꮻ": "WI",
    "Ꮼ": "WO",
    "Ꮽ": "WU",
    "Ꮾ": "WV",
    "Ꮿ": "YA",
    "Ᏸ": "YE",
    "Ᏹ": "YI",
    "Ᏺ": "YO",
    "Ᏻ": "YU",
    "Ᏼ": "YV",
    "Ᏽ": "MV",
    "ꭰ": "a",
    "ꭱ": "e",
    "ꭲ": "i",
    "ꭳ": "o",
    "ꭴ": "u",
    "ꭵ": "v",
    "ꭶ": "ga",
    "ꭷ": "ka",
    "ꭸ": "ge",
    "ꭹ": "gi",
    "ꭺ": "go",
    "ꭻ": "gu",
    "ꭼ": "gv",
    "ꭽ": "ha",
    "ꭾ": "he",
    "ꭿ": "hi",
    "ꮀ": "ho",
    "ꮁ": "hu",
    "ꮂ": "hv",
    "ꮃ": "la",
    "ꮄ": "le",
    "ꮅ": "li",
    "ꮆ": "lo",
    "ꮇ": "lu",
    "ꮈ": "lv",
    "ꮉ": "ma",
    "ꮊ": "me",
    "ꮋ": "mi",
    "ꮌ": "mo",
    "ꮍ": "mu",
    "ꮎ": "na",
    "ꮏ": "hna",
    "ꮐ": "nah",
    "ꮑ": "ne",
    "ꮒ": "ni",
    "ꮓ": "zo",
    "ꮔ": "nu",
    "ꮕ": "nv",
    "ꮖ": "qua",
    "ꮗ": "que",
    "ꮘ": "qui",
    "ꮙ": "quo",
    "ꮚ": "quu",
    "ꮛ": "quv",
    "ꮜ": "sa",
    "ꮝ": "s",
    "ꮞ": "se",
    "ꮟ": "si",
    "ꮠ": "so",
    "ꮡ": "su",
    "ꮢ": "sv",
    "ꮣ": "da",
    "ꮤ": "ta",
    "ꮥ": "de",
    "ꮦ": "te",
    "ꮧ": "di",
    "ꮨ": "ti",
    "ꮩ": "do",
    "ꮪ": "du",
    "ꮫ": "dv",
    "ꮬ": "dla",
    "ꮭ": "tla",
    "ꮮ": "tle",
    "ꮯ": "tli",
    "ꮰ": "tlo",
    "ꮱ": "tlu",
    "ꮲ": "tlv",
    "ꮳ": "tsa",
    "ꮴ": "tse",
    "ꮵ": "tsi",
    "ꮶ": "tso",
    "ꮷ": "tsu",
    "ꮸ": "tsv",
    "ꮹ": "wa",
    "ꮺ": "we",
    "ꮻ": "wi",
    "ꮼ": "wo",
    "ꮽ": "wu",
    "ꮾ": "wv",
    "ꮿ": "ya",
    "ᏸ": "ye",
    "ᏹ": "yi",
    "ᏺ": "yo",
    "ᏻ": "yu",
    "ᏼ": "yv",
    "ᏽ": "mv"
}

