{
    "ぁ": "a",
    "あ": "A",
    "ぃ": "i",
    "い": "I",
    "ぅ": "u",
    "う": "U",
    "ぇ": "e",
    "え": "E",
    "ぉ": "o",
    "お": "O",
    "か": "KA",
    "が": "GA",
    "き": "KI",
    "ぎ": "GI",
    "く": "KU",
    "ぐ": "GU",
    "け": "KE",
    "げ": "GE",
    "こ": "KO",
    "ご": "GO",
    "さ": "SA",
    "ざ": "ZA",
    "し": "SI",
    "じ": "ZI",
    "す": "SU",
    "ず": "ZU",
    "せ": "SE",
    "ぜ": "ZE",
    "そ": "SO",
    "ぞ": "ZO",
    "た": "TA",
    "だ": "DA",
    "ち": "TI",
    "ぢ": "DI",
    "っ": "tu",
    "つ": "TU",
    "づ": "DU",
    "て": "TE",
    "で": "DE",
    "と": "TO",
    "ど": "DO",
    "な": "NA",
    "に": "NI",
    "ぬ": "NU",
    "ね": "NE",
    "の": "NO",
    "は": "HA",
    "ば": "BA",
    "ぱ": "PA",
    "ひ": "HI",
    "び": "BI",
    "ぴ": "PI",
    "ふ": "HU",
    "ぶ": "BU",
    "ぷ": "PU",
    "へ": "HE",
    "べ": "BE",
    "ぺ": "PE",
    "ほ": "HO",
    "ぼ": "BO",
    "ぽ": "PO",
    "ま": "MA",
    "み": "MI",
    "む": "MU",
    "め": "ME",
    "も": "MO",
    "ゃ": "ya",
    "や": "YA",
    "ゅ": "yu",
    "ゆ": "YU",
    "ょ": "yo",
    "よ": "YO",
    "ら": "RA",
    "り": "RI",
    "る": "RU",
    "れ": "RE",
    "ろ": "RO",
    "ゎ": "wa",
    "わ": "WA",
    "ゐ": "WI",
    "ゑ": "WE",
    "を": "WO",
    "ん": "N",
    "ゔ": "VU",
    "ゕ": "ka",
    "ゖ": "ke",
    "ゟ": "YORI"
}
